#    B#
# ### #
# ##  #
# ## ##
     ##
##A####