#           B#
# ########## #
# #        # #
# # ###### # #
#   #      # #
### # ###### #
A   #        #